1111111
10E0001
1000PC1
1000001
1111111
