1111111111111111111
1000000000C00010001
1000000000000010001
1000000000000011111
1000000000000000001
1000000000000000001
1000000000000000001
1000000000000000001
10000C000P000000011
10000C000C0C0000001
10000C000C0C00000E1
1111111111111111111
